Window
+-----------------------------+
|         width               |
|         <--->               |
|        *-----+-----+-----+  | 
|      ^ |(x,y)|     |     |  | 
|height| |     |     |     |  | 
|      v |     |     |     |  | 
|        +-----+-----+-----+  | 
|        |     |     |     |  | 
|        |     |     |     |  | 
|        |     |     |     |  | 
|        +-----+-----+-----+  | 
|        |     |     |     |  | 
|        |     |     |     |  | 
|        |     |     |     |  | 
|        +-----+-----+-----+  | 
|        Local Binary Pattern |
|                             |
+-----------------------------+      

